10-01-2006
09-04-2016
28-02-2010
15-07-2018
30-10-2009
27-03-1999
21-02-2016
18-07-2005
20-02-2000
08-05-2005
12-08-2000
25-08-2017
10-12-2009
03-08-2015
07-01-2010
03-08-2018
14-09-2003
03-08-2021
23-11-2014
25-09-2006
30-06-2020
29-04-2019
20-10-2016
03-09-1999
18-03-2006
01-05-2004
16-01-2018
25-06-2006
19-12-2018
04-08-2001
29-05-2022
12-07-2013
18-02-2018
31-07-1997
05-12-2021
21-11-2013
07-10-2005
