28-09-2005
23-03-2002
16-11-2009
06-07-2007
05-09-2011
16-01-1998
