22-07-2003
27-05-2019
19-08-2022
16-03-2011
09-02-2006
08-03-1999
28-04-1999
10-12-2015
20-05-2014
28-05-2007
11-01-2024
14-10-1999
29-04-1998
15-12-2016
13-04-2001
03-02-2003
08-05-2012
14-08-1998
01-10-2022
28-08-2012
10-02-2017
20-05-2003
28-03-2019
21-12-2003
29-06-2011
18-09-2013
22-06-2008
16-12-2022
25-03-2004
21-07-2009
05-07-2005
17-06-2014
09-06-2013
19-11-2016
31-10-2009
18-04-1998
11-08-2008
04-07-2013
04-05-2017
18-05-2003
29-07-2007
15-11-1997
19-02-2009
14-08-2023
06-10-2024
07-11-2003
06-03-2006
26-06-2023
13-09-2010
22-06-2005
17-08-2000
29-02-2004
18-01-2011
16-05-2010
27-12-2004
15-03-2003
17-09-2017
08-05-2004
24-03-2021
06-01-2018
16-07-2015
06-04-2006
13-03-2019
24-07-2018
27-12-2017
01-05-2022
27-07-2000
07-09-2012
13-09-2000
24-04-1999
07-04-2016
07-09-2001
18-01-2016
14-05-2020
05-08-1997
24-08-2010
28-12-2001
23-09-2012
26-08-2011
04-01-2005
03-11-2013
20-07-2020
23-09-2012
21-11-2013
16-01-2006
06-03-2006
13-01-2015
26-04-2009
30-10-2011
31-10-1998
23-02-2022
05-09-2001
01-06-2023
19-09-1997
16-11-2023
16-03-2017
02-04-2000
02-03-2011
14-04-2008
29-04-2011
