15-11-2005
01-05-2019
19-06-1999
20-02-2004
11-04-2024
29-06-2005
25-02-2023
09-12-2007
10-11-2013
30-11-2001
09-09-2002
29-01-2021
13-03-2000
09-04-2000
20-05-2013
22-05-2010
12-04-2011
11-04-2011
28-11-2001
08-09-2022
22-10-2003
25-10-2002
04-11-2005
25-10-2007
30-03-2024
30-05-2017
14-09-2001
17-04-1997
06-07-2015
30-01-1998
11-08-2010
30-08-2013
20-02-2013
03-06-2012
28-09-2007
17-10-2016
17-11-1999
04-01-2020
05-06-2013
03-12-1997
23-01-2010
22-01-2020
30-07-2008
14-02-2019
15-12-2022
24-03-2016
25-06-2022
05-05-2002
11-12-1996
16-02-2013
07-02-2020
08-11-2003
01-07-2014
13-12-2016
28-05-2008
22-01-2012
12-03-2018
08-09-2006
06-02-2023
08-12-2001
26-03-2011
06-04-1998
09-11-2014
31-01-2008
06-07-2012
15-03-2014
11-02-2011
27-10-2004
11-05-2013
01-10-2015
16-04-2019
17-09-2003
21-08-2000
