18-01-2004
19-10-2005
06-03-2005
19-07-2013
21-05-2013
21-12-2008
28-03-2008
05-11-2012
19-02-2011
10-09-2024
18-03-2014
01-08-1998
24-05-2015
16-02-2003
06-05-2012
22-07-2019
27-10-1997
20-04-2005
30-12-1999
07-08-2006
28-03-2022
09-01-2008
21-01-2019
16-04-2022
14-02-2018
25-09-2015
28-07-2021
02-01-2001
27-05-2020
14-02-2010
02-04-2012
18-10-2018
19-12-2011
31-03-2021
27-01-2015
11-03-2002
22-11-2021
05-10-2005
18-01-1998
14-02-2023
20-08-1997
08-08-2014
17-02-2022
12-04-2000
26-03-2016
30-09-2004
04-04-2006
05-12-2017
19-11-2013
28-05-2015
09-07-2007
24-01-2003
12-12-2007
04-12-2023
10-07-2017
25-07-2008
29-12-2015
22-02-2006
08-01-2013
26-11-1996
19-02-2020
