15-04-2008
17-11-2008
25-11-2016
21-10-2021
10-07-2006
29-04-2019
02-05-2024
28-10-2022
05-06-2007
04-04-2018
27-03-2009
21-10-2016
24-04-2013
05-06-2007
18-11-2016
24-07-1998
26-07-2012
19-12-2011
25-09-2014
24-09-2004
31-03-2010
30-04-2019
