22-08-2010
05-08-1999
23-12-2005
08-12-2024
17-01-2009
12-10-2024
03-12-2015
15-03-2001
19-01-2004
17-02-2022
21-09-2001
29-09-2014
23-04-2018
18-06-2006
11-06-2011
03-12-2010
13-04-2010
27-10-1999
10-04-2013
08-06-2001
28-05-2015
16-10-2008
31-05-2007
21-06-2010
15-01-2012
03-09-2003
03-01-2013
01-04-2002
18-11-1998
12-05-2003
22-10-1998
18-04-1998
07-01-2004
23-05-2009
10-08-2019
08-11-2014
27-11-2011
01-05-2016
14-05-2005
18-02-2023
11-11-2016
22-10-2006
16-03-2015
11-08-2014
03-12-1999
18-05-2004
28-02-2018
11-09-2011
06-07-2007
14-09-2010
13-12-1997
05-05-2006
19-12-2004
09-06-2015
11-08-2000
07-07-1999
08-02-2021
24-09-2005
09-01-2010
30-01-2005
16-10-2001
18-10-2013
23-08-2015
29-03-2007
28-08-2006
09-04-2000
30-03-2008
13-09-2021
08-05-2021
03-11-2007
09-08-2008
25-03-2020
15-09-2005
06-10-2009
15-09-2008
