02-03-2002
11-09-1997
17-09-2004
29-06-2019
03-07-2019
06-09-2004
02-09-2019
29-05-2003
19-02-2000
16-05-2000
23-07-2001
22-02-2008
05-03-2008
12-12-2000
21-10-2007
09-04-1997
14-12-2023
28-06-2002
17-02-2012
01-11-2020
31-08-2017
29-06-2002
25-09-2000
13-07-2015
01-12-2024
22-01-2022
20-09-2009
09-08-2000
07-05-2008
26-11-1999
19-06-2023
25-07-2016
13-02-2010
03-09-1997
31-05-2015
16-02-2000
04-06-2017
01-05-2009
29-03-1998
03-03-2002
13-08-2000
29-03-2008
03-09-2004
07-04-2020
