11-11-2006
02-02-2009
21-03-2018
22-07-2009
07-12-1999
20-07-2022
07-09-2018
25-09-2010
02-05-2014
26-10-2003
22-06-2008
07-07-1999
18-11-2011
16-02-2022
30-04-2020
21-01-1998
12-05-2002
11-05-2024
07-10-2020
27-06-2003
22-02-2016
02-11-2007
09-12-2024
15-03-2005
02-07-2020
24-10-2012
15-09-1997
18-02-2000
08-10-2006
04-08-2024
26-06-2021
30-12-2002
09-01-2018
14-01-2014
03-03-2022
08-11-2015
27-01-2013
