03-01-2010
16-04-2005
14-01-2003
02-02-1997
21-12-2004
18-05-2002
17-04-2024
13-01-2013
30-07-1997
05-12-2010
08-01-2002
28-10-2005
08-06-1998
27-07-2002
26-03-2015
14-02-2014
18-09-2016
22-06-2020
20-04-2012
14-10-2009
07-09-2024
08-11-2009
25-02-2006
31-03-2017
13-10-2014
07-06-2001
27-02-2019
24-12-2019
13-01-2020
07-08-2004
01-01-2005
13-09-2017
31-01-1998
09-04-2008
08-03-1999
02-06-2008
09-04-1997
08-10-2014
19-09-2010
13-06-2008
16-09-2024
05-05-2021
18-10-2024
13-08-2024
08-07-2008
04-06-2015
19-02-2015
10-04-2016
11-03-1998
29-12-2022
29-06-2023
06-04-2010
09-11-2005
23-05-2012
08-03-2001
10-11-2015
14-01-2024
14-03-2009
22-12-2003
31-05-2012
08-09-2013
05-09-2018
23-12-1999
10-10-2019
12-02-2020
03-05-2021
26-06-1997
